                ░

                      ░░░░░░░░░ ░░░
                ▒░░░▒▒░░░░░░░░░░░▒▒▒▒░▒▒▒▒░▒
             ▒▒▒▒▒▓▓▓▓▓▓▓▓▓▓▓▓▓▓▓▒▒▒▒██▓▓▒▓█▓▒▒
             ▒▒▒▓▓██▓█▓███▓█▓███▓▓▓░▒███▒░▓██▒▒
             ▒▒▒▓▓▓▓▓▓▓▓▓▓▓▓▓▓▓▓▓▓▓░▒▒▒▒▒▒▒▒▒▒▒
             ▒▒▒▓▓▓▓▓▓▓▓▓▓▓▓▓▓▓▓▓▓▓░▒▒▓▒  ░▓▒▒▒
             ▒▒▒▓▒▓▓▒▒▒▒▒▒▒▒▒▒▒▒▒▒▓▒▒▒▒▒▒▒▒▒▒▒▒
               ░░░░░                ░   ░▒░░░
