           ▒▒░▒▒▒▒▓▓▓▓▒▒▒▒▒▒▒▒▒▒▒▒▒▒▒▒▓▓▓▒▒▒▒▒░▒▒
          ░█░▒██▓▓▓▓▓▓██████████▓█▓▓██▓██▒░░░▓▒░█░
          ░▓▒▒▓▓▓▓▓▓▒▒▓▓▓▓▒▒▒▒▒▒▒▒▒▒▒▒▒▒▒▒▒░▒▒▒▒▓░
          ░▓▓▓▓▓▓▓▓▓▓▓▓▓▓▓▓▓▓▓▓▓▓▓▓▓▒▒▒▒▒▒▒░▒▓▓▓▓░
          ░▓▓▓▓▓▓▓▓▓▓▓▓▓▓▓▓▓▓▓▓▓▓▓▓▓░▒▒▒▒▒░░░░▒▓▓░
          ░▓▓▒▓▓▓▓▓▓▓▓▓▓▓▓▓▓▓▓▓▓▓▓▓▓▒▓▓▒▓▓▓▒▒▒▓▓▓░
            ░ ░▒▒▒░░                ░░░░░▒▒▒▒░░░
